███████╗██████╗0███████╗
██╔════╝██╔══██╗██╔════╝
█████╗00██║00██║█████╗00
██╔══╝00██║00██║██╔══╝00
██║00000██████╔╝██║00000
╚═╝00000╚═════╝0╚═╝00000